....................
....................
....................
....................
.....####....####...
.....#...#..#...#...
.....#....##....#...
......#.........#...
.......#.......#....
........#.....#.....
.........#...#......
..........#.#.......
....................
....................
....................